абсолютный - совершенный; крутой
абстрактный - отвлеченный
аграрный - земледельческий
адекватный - соответствующий
активный - деятельный
актуальный - злободневный
аморальный - безнравственный
анализ - разбор
антураж - окружение
аргумент - довод
бизнес - дело
бойфренд - приятель
брифинг - летучка
вариант - разновидность
габариты - размеры
герметичный - непроницаемый
гипотетический - предположительный
голкипер - вратарь
гуманность - человечность
дайвер - ныряльщик
дайджест - обзор
дебаты - прения
девальвация - обесценивание
демонстрация - показ
деструктивный - разрушительный
детальный - подробный
диалог - беседа
директор - управляющий
дискомфорт - неудобство
дискуссия - обсуждение; спор
дифференциация - разделение
доминировать - господствовать; преобладать
дуэль - поединок
игнорировать - пренебрегать
идентичный - тождественный
имидж - образ
импорт - ввоз
индивидуальный - единоличный
индифферентный - безразличный
индустрия - промышленность
инертный - равнодушный
интервенция - вторжение
интернациональный - международный
инфицированный - зараженный
информация - сведения
камуфляж - прикрытие
коммерсант - торговец
компенсация - возмещение
комфорт - удобство
комфортабельный - удобный; благоустроенный
конкретный - определенный
конкурент - соперник
конкурс - состязание
констатировать - устанавливать
конструировать - устраивать; строить
конструктивный - созидательный
континент - материк
контракт - договор
конфронтация - противостояние
концентрация - сосредоточение
коррективы - поправки
корреспонденция - переписка; сообщение
кредитор - заимодатель
криминальный - преступный
легитимный - законный
лепта - вклад
ликвидация - уничтожение
лингвист - языковед
лифтинг - подтяжка кожи
максимальный - наибольший; предельный
маска - личина
менталитет - склад ума
метод - прием
минимальный - наименьший
мобильность - подвижность
модель - образец
модернизация - обновление
момент - миг
моментальный - мгновенный
монолог - речь
монумент - памятник
монументальный - величественный
натуральный - естественный
негативный - отрицательный
нивелировать - уравнивать
объективный - беспристрастный
оригинал - подлинник
отель - гостиница
параметр - величина
паркинг - стоянка
пассивный - бездеятельный
персональный - личный
плюрализм - множественность
позитивный - положительный
полемика - спор
потенциальный - возможный
превалировать - преобладать
претензия - притязание
прециозный - точный
приватный - частный
примитив - посредственность
прогноз - предсказание
прогресс - продвижение
пропаганда - распространение
публикация - обнародование; издание
радикальный - коренной
реакция - отклик
реализовать - претворить в жизнь
ревизия - проверка
революция - переворот
регресс - упадок
резолюция - решение
резонанс - отзвук
результат - следствие; последствие
реконструкция - перестройка
рельеф - очертание
ренессанс - возрождение
респектабельный - приличный
реставрация - восстановление
реформа - преобразование
секретный - тайный
сервис - обслуживание
симпозиум - заседание
симптом - признак
синтез - сбор; обобщение
синхронно - одновременно
ситуация - положение; обстановка
социальный - общественный
социология - обществоведение
спонсор - благотворитель; меценат
стабильность - устойчивость
стагнация - застой
стресс - напряжение; потрясение
структура - устройство
субъективный - личный; предвзятый
сфера - область
тема - предмет
толерантность - терпимость
томаты - помидоры
трансформация - превращение
фактический - действительный
форум - собрание
фундаментальный - основополагающий
хобби - увлечение
шеф - глава
шопинг - покупки
шоу - зрелище
эксклюзивный - исключительный
эксперимент - опыт
экспозиция - выкладка
экспорт - вывоз
эмбрион - зародыш
эра - летосчисление
юриспруденция - правоведение
